1111111111111111111111111111111111111111111111111111111111111111
1000000000000000000000000000000000000222222222222222222200000001
1000000000000000000000000000000000000022222222222222222200000001
1000000000222000000000000000000000000022222222222222222500000001
1000000002222200000000000000000000000022222222222222222000000001
1000005222222220000000000004334000000002222222222222225000000001
1000052222222222000000000003333000000000222222222222200000000001
1000022222222222200000000003333000000000022222222222200000000001
1000022222222222220000000004334000000000002222222222500000000001
1000022222222222220000000000000000000000000222222225000000000001
1000052222222222220000000000000000000000000002222200000000000001
1000005222222222200000000000000000000000000000000000000000000001
1000000002222222000000000000000000000000000000000000000000000001
1000000000022200000000000000000000000000000000000000000000000001
1000000000000000000000000000000000000000000000000000000000000001
1000000000000000000000000000000000000000000000000000000043340001
1000000000000000000000000000000000000000000000000000000033330001
1000043340000000000000000000000000000000000000000000000033330001
1000033330000000000000000000000000000000000000000000000043340001
1000033330000000000000000000000000000000000000000000000000000001
1000043340000000000000000000000000000000000000000000000000000001
1000000000000000000000000000000000000000000000000000000000000001
1000000000000000000000000000000000000000000000000022200000000001
1000000000000000000000000000000000000000000000002222222000000001
1000000000000000000000000000000000000000000000022222222225000001
1000000000000222220000000000000000000000000000222222222222500001
1000000000052222222200000000000000000000000000222222222222200001
1000000000522222222220000000000433400000000000222222222222200001
1000000000222222222222000000000333300000000000022222222222200001
1000000000222222222222200000000333300000000000002222222222500001
1000000052222222222222220000000433400000000000000222222225000001
1000000022222222222222222000000000000000000000000022222000000001
1000000522222222222222222000000000000000000000000002220000000001
1000000222222222222222222000000000000000000000000000000000000001
1000000222222222222222222200000000000000000000000000000000000001
1111111111111111111111111111111111111111111111111111111111111111
